# General
TYPE = Tipo
START = Start
STOP = Stop
NONE_HIM = Nessuno
NONE_HER = Nessuna

# Math
POSITIVE = Positivo
NEGATIVE = Negativo
ALTERNATE = Alternato
RANDOM = Random
RANDOM_SHORT = Rnd
VALUE = Valore
SIGN = Segno
SPINNER = Spinner
RANGE = Range
CONSTANT = Costante
CONSTANT_SHORT = Cost
CLASSIC = Classico
STEPPED = A Gradino
POLYLINE = Polilinea
BEZIER = Bezier
UNIFORM_SIGN = Segno Uniforme
LENGTH = Lunghezza
START_ANGLE = Angolo Iniziale
ANGLE = Angolo
FIXED = Fisso
CUMULATIVE = Cumulativo
RELATIVE_TO_PATH = Relativo al Percorso
DELAYED = Ritardato

# Color
COLOR = Colore
OPACITY = Opacità
GRADIENT_COLOR = Colore a Gradiente
MIRRORED = Riflesso
GRAY = Grigio
INVERTED = Invertito
FILLING = Riempimento
LIGHTING = Illuminazione
LIGHTED = Illuminato
DARKENED = Incupito
SPATIAL = Spaziale
TEMPORAL = Temporale

# Label
INTENSITY = Intensità
MULTIPLICITY = Molteplicità
PUSH = Spinta
ROTATION = Rotazione
ATTACK = Attacco
SUSTAIN = Sostegno
RELEASE = Rilascio
ENDLESS = Infinito
STEP = Passo
SHAPE = Forma
SIZE = Dimensione
SHADOW = Ombra
BORDER = Bordo
WIDTH = Larghezza
HEIGHT = Altezza
REGULAR = Regolare
SHADOW = Ombra
DELTA_X = Delta X
DELTA_Y = Delta Y
BORDER = Bordo
ARROW_MODULE = Modulo Freccia
RADIUS = Raggio
SPEED = Velocità